//MAP CONVERTED BY dmm2tgm.py THIS HEADER COMMENT PREVENTS RECONVERSION, DO NOT REMOVE
"ao" = (
/obj/effect/wall_vent,
/turf/closed/wall/mineral/iron{
	opacity = 0
	},
/area/city/backstreets_room)
"az" = (
/obj/structure/chair{
	dir = 8
	},
/obj/structure/sign/poster/official/random{
	pixel_x = 32
	},
/turf/open/floor/stone,
/area/city/backstreets_room)
"cY" = (
/obj/machinery/door/sigsystem{
	name = "storage locker 1552";
	lock_signaller_code = 565;
	autoclose = 1
	},
/obj/effect/decal/cleanable/blood/footprints,
/turf/open/floor/stone,
/area/city/backstreets_room)
"dL" = (
/obj/effect/decal/cleanable/dirt,
/obj/structure/sign/poster/official/random{
	pixel_x = 13;
	pixel_y = 32
	},
/turf/open/floor/stone,
/area/city/backstreets_room)
"eD" = (
/obj/effect/decal/cleanable/dirt,
/turf/open/floor/stone,
/area/city/backstreets_room)
"eI" = (
/obj/effect/decal/cleanable/dirt/dust,
/turf/closed/indestructible/reinforced,
/area/city/backstreets_room)
"fu" = (
/obj/structure/chair{
	dir = 8
	},
/turf/open/floor/stone,
/area/city/backstreets_room)
"gQ" = (
/obj/effect/decal/cleanable/dirt,
/turf/open/floor/wood,
/area/city/backstreets_room)
"iJ" = (
/obj/structure/closet/crate/sigsystem,
/obj/effect/spawner/lootdrop/chaotic_random,
/turf/open/floor/stone,
/area/city/backstreets_room)
"jJ" = (
/obj/machinery/door/sigsystem{
	lock_signaller_code = 556;
	autoclose = 1;
	name = "nest checkpoint 1234"
	},
/turf/open/floor/stone,
/area/city/backstreets_room)
"kl" = (
/obj/effect/decal/cleanable/dirt,
/obj/effect/decal/cleanable/dirt,
/turf/open/floor/stone,
/area/city/backstreets_room)
"oD" = (
/turf/closed/wall/mineral/iron,
/area/city/backstreets_room)
"qq" = (
/obj/structure/seed_grinder,
/turf/open/floor/wood,
/area/city/backstreets_room)
"rp" = (
/obj/effect/decal/cleanable/blood/footprints{
	dir = 8
	},
/obj/effect/decal/cleanable/dirt,
/turf/open/floor/stone,
/area/city/backstreets_room)
"sH" = (
/obj/structure/sigsystem/keypad{
	signaller_code = 556;
	signaller_range = 2;
	pixel_y = 32
	},
/obj/effect/spawner/lootdrop/cigbutt,
/turf/open/floor/stone,
/area/city/backstreets_room)
"us" = (
/obj/structure/table/wood,
/obj/item/flashlight/lantern{
	on = 1
	},
/turf/open/floor/stone,
/area/city/backstreets_room)
"xh" = (
/obj/structure/sigsystem/keypad{
	signaller_code = 565;
	signaller_range = 2;
	pixel_y = -22;
	dir = 1;
	code_soln = "1552"
	},
/turf/open/floor/stone,
/area/city/backstreets_room)
"xx" = (
/obj/machinery/door/airlock/public,
/turf/open/floor/stone,
/area/city/backstreets_room)
"yp" = (
/obj/effect/decal/cleanable/dirt,
/obj/structure/chair{
	dir = 8
	},
/turf/open/floor/stone,
/area/city/backstreets_room)
"zi" = (
/obj/effect/decal/cleanable/dirt/dust,
/turf/open/floor/stone,
/area/city/backstreets_room)
"zw" = (
/obj/structure/window,
/obj/effect/decal/cleanable/dirt,
/turf/open/floor/wood,
/area/city/backstreets_room)
"zI" = (
/turf/open/floor/plating/asteroid/basalt,
/area/city/backstreets_room)
"Af" = (
/turf/open/floor/stone,
/area/city/backstreets_room)
"AJ" = (
/obj/machinery/button/sigsystem{
	pixel_y = -32;
	signaller_code = 556;
	pixel_x = 6;
	use_power = 0
	},
/turf/open/floor/stone,
/area/city/backstreets_room)
"Co" = (
/obj/effect/decal/cleanable/glass,
/obj/effect/decal/cleanable/blood/old,
/obj/effect/decal/cleanable/blood/gibs/down,
/turf/open/floor/stone,
/area/city/backstreets_room)
"Cy" = (
/obj/effect/decal/cleanable/dirt/dust,
/turf/closed/wall/mineral/iron,
/area/city/backstreets_room)
"CJ" = (
/obj/structure/sigsystem/deployer{
	pixel_x = 30;
	spawn_flavor_text = "emerges from the crate";
	atom_rename = "checkpoint killer";
	atom_path = /mob/living/simple_animal/hostile/humanoid/blood/bag;
	spawn_dist_x = 1;
	signaller_range = 1
	},
/turf/closed/indestructible/reinforced,
/area/city/backstreets_room)
"FM" = (
/obj/effect/decal/cleanable/dirt/dust,
/obj/effect/decal/cleanable/blood/footprints,
/turf/open/floor/stone,
/area/city/backstreets_room)
"GS" = (
/obj/structure/filingcabinet/chestdrawer,
/turf/open/floor/stone,
/area/city/backstreets_room)
"Hf" = (
/obj/effect/decal/cleanable/glass,
/turf/open/floor/stone,
/area/city/backstreets_room)
"Hg" = (
/obj/effect/decal/cleanable/dirt/dust,
/obj/effect/decal/cleanable/glass,
/obj/effect/spawner/structure/window,
/turf/open/floor/plating/rust,
/area/city/backstreets_room)
"Hh" = (
/obj/effect/decal/cleanable/blood/old,
/obj/item/clothing/shoes/sneakers/black,
/turf/open/floor/stone,
/area/city/backstreets_room)
"Hw" = (
/obj/effect/decal/cleanable/dirt,
/obj/effect/decal/cleanable/glass,
/obj/effect/decal/cleanable/blood/old,
/obj/item/clothing/under/suit/black,
/turf/open/floor/stone,
/area/city/backstreets_room)
"HR" = (
/obj/effect/decal/cleanable/dirt/dust,
/obj/structure/closet/crate/sigsystem,
/obj/effect/spawner/lootdrop/workshop_random,
/turf/open/floor/stone,
/area/city/backstreets_room)
"Iv" = (
/obj/effect/decal/cleanable/dirt,
/obj/item/kirbyplants/potty,
/turf/open/floor/stone,
/area/city/backstreets_room)
"Jg" = (
/obj/effect/decal/cleanable/blood/footprints{
	dir = 8
	},
/turf/open/floor/stone,
/area/city/backstreets_room)
"Jw" = (
/obj/structure/sign/poster/official/random{
	pixel_x = 32
	},
/obj/item/kirbyplants/potty,
/turf/open/floor/stone,
/area/city/backstreets_room)
"KO" = (
/obj/item/flashlight/lantern,
/turf/open/floor/stone,
/area/city/backstreets_room)
"KU" = (
/obj/effect/decal/cleanable/blood/footprints,
/obj/effect/decal/cleanable/blood/footprints{
	dir = 8
	},
/turf/open/floor/stone,
/area/city/backstreets_room)
"Lt" = (
/obj/effect/decal/cleanable/dirt/dust,
/obj/structure/reagent_dispensers/compostbin,
/turf/open/floor/wood,
/area/city/backstreets_room)
"Ma" = (
/obj/structure/sign/departments/cargo{
	pixel_y = -32
	},
/obj/effect/decal/cleanable/dirt,
/turf/open/floor/stone,
/area/city/backstreets_room)
"Mo" = (
/obj/item/trash/can/food/peaches,
/obj/machinery/smartfridge/bottlerack/seedbin/preload{
	pixel_y = 6
	},
/obj/structure/window,
/turf/open/floor/wood,
/area/city/backstreets_room)
"MT" = (
/obj/effect/decal/cleanable/blood/footprints,
/obj/effect/decal/cleanable/blood/gibs/old,
/turf/open/floor/stone,
/area/city/backstreets_room)
"NA" = (
/obj/effect/decal/cleanable/blood/splatter/over_window,
/turf/closed/wall/mineral/iron,
/area/city/backstreets_room)
"OG" = (
/obj/effect/decal/cleanable/blood/old,
/obj/effect/decal/cleanable/blood/gibs/old,
/obj/item/chair,
/turf/open/floor/stone,
/area/city/backstreets_room)
"PU" = (
/obj/effect/spawner/mobspawner/rat{
	max_spawns = 3
	},
/turf/open/floor/stone,
/area/city/backstreets_room)
"QO" = (
/obj/item/trash/can/food/peaches,
/turf/open/floor/stone,
/area/city/backstreets_room)
"RD" = (
/obj/effect/decal/cleanable/glass,
/turf/open/floor/wood,
/area/city/backstreets_room)
"Uj" = (
/obj/machinery/hydroponics,
/obj/item/food/grown/harebell,
/turf/open/floor/wood,
/area/city/backstreets_room)
"UI" = (
/obj/effect/decal/cleanable/dirt,
/obj/item/shard,
/obj/structure/grille/broken,
/obj/effect/decal/cleanable/glass,
/turf/open/floor/plating/rust,
/area/city/backstreets_room)
"Vd" = (
/obj/structure/table_frame,
/obj/effect/decal/cleanable/glass,
/obj/item/shard,
/obj/effect/decal/cleanable/blood/old,
/turf/open/floor/stone,
/area/city/backstreets_room)
"Vf" = (
/obj/structure/table/wood,
/obj/item/newspaper,
/obj/item/newspaper{
	pixel_y = 8;
	pixel_x = -8
	},
/obj/item/newspaper{
	pixel_x = -7;
	pixel_y = -2
	},
/turf/open/floor/stone,
/area/city/backstreets_room)
"VI" = (
/obj/effect/decal/cleanable/dirt,
/obj/item/trash/can/food/peaches,
/obj/effect/decal/cleanable/blood/old,
/obj/effect/decal/cleanable/blood/gibs/old,
/obj/structure/table_frame,
/obj/item/shard,
/turf/open/floor/stone,
/area/city/backstreets_room)
"WH" = (
/obj/effect/decal/cleanable/dirt/dust,
/obj/effect/decal/cleanable/dirt/dust,
/turf/closed/wall/mineral/iron,
/area/city/backstreets_room)
"Xo" = (
/obj/effect/decal/cleanable/blood/footprints,
/turf/open/floor/stone,
/area/city/backstreets_room)
"XN" = (
/turf/open/floor/wood,
/area/city/backstreets_room)
"ZO" = (
/obj/effect/decal/cleanable/dirt/dust,
/obj/machinery/button/sigsystem{
	pixel_y = 32;
	signaller_code = 565;
	pixel_x = 6;
	use_power = 0
	},
/obj/effect/spawner/lootdrop/medical_random,
/turf/open/floor/stone,
/area/city/backstreets_room)
"ZV" = (
/turf/closed/indestructible/reinforced,
/area/city/backstreets_room)

(1,1,1) = {"
ZV
ZV
ZV
ZV
ZV
ZV
zI
zI
zI
ZV
ZV
ZV
ZV
CJ
ZV
"}
(2,1,1) = {"
ZV
WH
Cy
oD
oD
oD
oD
xx
oD
oD
ZO
eD
iJ
HR
ZV
"}
(3,1,1) = {"
ZV
Cy
Lt
gQ
qq
Mo
Iv
Jg
Xo
cY
FM
Xo
FM
zi
ZV
"}
(4,1,1) = {"
ZV
Cy
Uj
gQ
XN
RD
Af
rp
xh
oD
zi
zi
zi
zi
ZV
"}
(5,1,1) = {"
ZV
Cy
oD
XN
RD
zw
Af
Jg
Ma
oD
ao
oD
oD
oD
ZV
"}
(6,1,1) = {"
zI
zi
oD
Hg
UI
oD
Hf
rp
AJ
oD
Af
Af
oD
Af
zI
"}
(7,1,1) = {"
zI
Af
xx
Af
Af
VI
MT
KU
Af
jJ
Af
eD
xx
eD
zI
"}
(8,1,1) = {"
zI
zi
oD
eD
Hw
Co
OG
Af
eD
oD
sH
Af
oD
Af
zI
"}
(9,1,1) = {"
ZV
oD
Cy
Cy
NA
Vd
Hh
Af
QO
oD
dL
Af
oD
oD
ZV
"}
(10,1,1) = {"
ZV
eI
ZV
Cy
GS
KO
Af
kl
Af
oD
Af
Af
Af
Vf
ZV
"}
(11,1,1) = {"
ZV
ZV
ZV
Cy
GS
kl
Af
Af
Jw
oD
Af
PU
eD
Af
ZV
"}
(12,1,1) = {"
ZV
eI
eI
Cy
oD
oD
oD
xx
oD
oD
us
az
fu
yp
ZV
"}
(13,1,1) = {"
ZV
ZV
ZV
ZV
ZV
ZV
zI
zI
zI
ZV
ZV
ZV
ZV
ZV
ZV
"}
